10,5

1,1,1,1,1,1,1,1,1,1
1,0,0,0,5,5,0,0,0,1
1,0,2,0,0,0,0,2,0,1
1,0,0,4,4,4,4,0,0,1
1,5,0,4,3,3,4,0,5,1

